ஆ - ஈ இ அ
ஈ - ஊ உ இ அ ஆ
ஊ - ஏ உ உ இ ஈ 
ஏ - ள எ ஐ உ ஊ
ள - ற க எ ஐ ஏ
ற - ன ப க எ ள
ன - ட ம ப க ற
ட - ண த ம ப ன
ண - ச ந த ம ட
ச - ஞ ய ந த ண
ஞ - ய ந ச

அ - ஆ இ ஔ
இ - ஊ உ ஔ அ ஆ ஈ
உ - ஏ ஐ ஓ ஔ இ ஈ ஊ
ஐ - ள எ ஒ ஓ உ ஊ
எ - ற க வ ஒ ஐ ஏ ள
க - ன ப ங வ எ ள ற
ப - ட ம ல ங க ற ன
ம - ண த ர ல ப ன ட
த - ச ந ழ ர ம ட ண
ந - ஞ ய ழ த ண ச
ய - ந ச ஞ

ஔ - உ ஓ இ
ஓ - உ ஐ ஒ ஔ
ஒ - எ வ ஓ ஐ 
வ - க ங ஒ எ
ங - ப ல வ க
ல - ம ர ங ப ்
ர - த ழ ல ம ்
ழ - ந ர த ்
